############################################################
#..........................................................#
#.###########..............................................#
#.#.........#..............................................#
#.#.........#..............................................#
#.#.........#..............................................#
#.#.........#..............................................#
#.########+##.....@........................................#
#..........................................................#
#..........................................................#
#.......................###########........................#
#.......................#.........#........................#
#.....#r#...............#.........#........................#
#.......................#.........#........................#
#.......................#.........#........................#
#.......................#.........#........................#
#.......................########+##........................#
#..........................................................#
#..........................................................#
#..........................................................#
#..........................................................#
#..........................................................#
############################################################
