##########
#........#
#........#
#......e.#
#...e....#
##########
