############################################################
#..........................................................#
#.###########..............................................#
#.#.........#..............#...............................#
#.#.........#..............#...............................#
#.#..e......#..............#.........#..........e..........#
#.#.........#..............#.........#.....................#
#.########+##..............#.........#.....................#
#..........................#.........#.....................#
#..........................#.........#.....................#
#.......................###########..#.....................#
#.........##########....#.........#..#.....................#
#.......................#.........#..#.....................#
#.......................#.........#..#.....................#
#....e..................#e........#..#.....................#
#.......................#.........#..#.....................#
#.......................########+##........................#
#..........................#...............................#
#..........................#...............................#
#..........................................................#
#..........................................................#
#..........................................................#
############################################################
