############-----
#..........#-----
#########..#-----
--------#..#-----
--------#..#-----
----#####ee####--
----#...eee...#--
----#..e.e....#--
----#.........#--
----###########--
