############################################################
#@.........................................................#
#.###########..............................................#
#.#.........#..............................................#
#.#.........#..............................................#
#.#.........#..............................................#
#.#T........#..............................................#
#.########+##..............................................#
#..........................................................#
#..........................................................#
#.......................###########........................#
#.......................#.........#........................#
#.......................#.........#........................#
#.......................#.........#........................#
#.......................#.........#........................#
#.......................#.........#........................#
#.......................########+##........................#
#..........................................................#
#..........................................................#
#..........................................................#
#..........................................................#
#..........................................................#
############################################################
